111111111111111111111111111111111111111
1                                     1
1   3       1            1            1
1           1            1            1
1           1            1            1
1           1            1            1
1           1            1            1
1                                     1
1                  2                  1
1 11111            2             111111
1                  2                  1
1                  2                  1
1      2                     2        1
1      2        1111111      2        1
1      2                     2        1
1      2                     2        1
1      2        1111111      2        1
1                                     1
1                                     1
1               1111111               1
1                                     1
1                                     1
1                                     1
1                                     1
1                                     1
1                                     1
1           1            1            1
1           1            1            1
1           1            1            1
1           1            1            1
1     2222222            222222       1
1                                     1
1           1            1            1
1           1            1            1
1           1            1            1
1           1            1            1
1           1            1            1
1                             4       1
1                                     1
111111111111111111111111111111111111111